
NO s/brown.xpm
SO      s/orange.xpm
C 171,191,219
WE                   s/light_blue.xpm                         
EA s/magenta.xpm
F            42,98,61



       11     1     11
     11001   101   10011
   110001   10001   100011  
  1000001  1000001  1000001
 1000000011100000111000D0001
 100100000000000000000000001
100100000011000000010D0000001
10000001000000W00000D0000D0001
10000000100010000001000000001
 1000000000010000000000D0001
 100001100010000010001100001
  1001  111 10001 111  1001
   1001     10001     1001
    11       101       11
              1