
NO s/brown.xpm
SO      s/orange.xpm
C 171,191,219
WE                   s/light_blue.xpm                         
EA s/magenta.xpm
F            42,98,61



       11     1     11
     11001   101   10011
   110001   10001   100011  
  1000001  1000001  1000001
 100W000011100000111000D0001
 100000000000001000000000001
100000000011001 10010D0D00001
10000000000000010000D0D0D00001
10000000000010000001000D00001 
 100000000001DDDD000000D0001 
 100001100010000010001100001
  1001  111 10001 111  1001 
   1001     10001     1001
    11       101       11
              1
