
NO Makefile  
SO      Makefile
C 171,191,219
WE                   Makefile                         
EA Makefile
F            42,98,61
     
11111
10001
10101
10001
10101
10001
10011
10001
10101
1N001
11111
