
NO Makefile
SO      Makefile
C 171,191,219
WE                   Makefile                         
EA Makefile
F            42,98,61


11111111111111111111
10000000000000000001
10000010000000000001
10000010000000000001
10010011000000000001
10110001000000000001
10110001000000000001
10101010111111111101
10001010111111111101
10000000000000000001
10000100000000000001
10000010000000000001
10000W00000000000001
11111111111111111111