
NO s/N.xpm
SO      s/S.xpm
C 171,191,219
WE                   s/W.xpm                         
EA s/E.xpm
F            42,98,61



1111111111111111111111111111111
1000000000000000000000000000001
1001111111111111001001001001001
10000000000001 1001001000000001
1111111111001111111001111001101
1000000000001000000001000000001
1111001001111111111111001111001
1001001000001000000001001000001
1001001111111111001111111001101
1001001001000001001001001000001                 
1001001001001111001001001001001
1000000000001000001000001001001
1001111111111001001111001111101
1000000001000001001000000000001
1111111001111001111001001111001
1001000000001000001001001000001
1001001111001001111001111001111
1001000001000001000001000001001
1001111001111001001111111111001
10000000000010000000010000010W1
1111111111111111111111111111111
