
NO Makefile
SO      Makefile
C 171,191,219
WE                   Makefile                         
EA Makefile
F            42,98,61

       11     1     11
     11001   101   10011
   110001   10001   100011  
  1000001  1000001  1000001
 100000001110000011100000001
 100100000000000000000000001
10010000001100000001000000001
10000001000000S000001000000001
10000000100010000001000000001
 100000000001000000000000001
 100001100010000010001100001
  1001  111 10001 111  1001
   1001     10001     1001
    11       101       11
              1