
NO Makefile  
SO      Makefile
C 171,191,219
WE                   Makefile                         
EA Makefile
F            42,98,61
     
11111111111
1000000111
101010000111
100010000111
10101000011111
1000111000000111
10010000111111
10000000111
101010000111
1N00000111
11111111111
