
NO s/N.xpm
SO      s/S.xpm
C 171,191,219
WE                   s/W.xpm                         
EA s/E.xpm
F            42,98,61


   11111                        11    11
  11   11111111111     1111 11  1001  1001
1111111110000000001   1000111  1001  1001
1100000000011110001111000001  1001  1001
11100001111   110001000011  1001  1001
 1 1011        1100010011   1001  1001
 1100111111  111000000N1   1001  1001
10000000001110000010101   1001  1001
1111100000000001111111111  1001  1001
  111111111111111           11    11
