


NO Makefile  
SO      Makefile
C 170,191,209










WE                   Makefile                         
EA Makefile





      

      



F            42,98,61
11111
10001
10N0110001
11111