
NO Makefile  
SO      Makefile
C 171,191,219
WE                   Makefile                         
EA Makefile
F            42,98,61
1111111111111
100000S000001
1000000000001
1000000000001
1000000000001
1000010100001
1000000000001
1010000000101
1000000000001
1000000000001
1001000001001
1000000000001
1000000000001
1000000000001
1111111111111