NO ./path_to_the_north_texture  

SO ./path_to_the_south_texture
C 225,30,0










WE                   ./path_to_the_west_texture                         
EA ./path_to_the_east_texture





      





F            220,100,0
  
        1111011111111101111111111
        1000000000110000000000001
        1011000001110000000000000
        0001000000000000000000001
011111111011000001110000000000001
0000000000000000110101001000111111111111
11000001110101011111011110N010110101011
11110111 1110101 0011110100011100101011111
100000000011101101010111111000000111111
100000000011    1110111111000000111
0011011111110111110000001000111
0100000011010101110010010000
11000000000000001100000010000
00000000000000001101010010001
11000001110101011111011110N0101
11110111 1110101 001111010001
01111101 1111011 101110111111
